1111111111111111111111111111111111111111111111111111111111111111111111111111111111111111111111111111111111111111111111111111111111111111111
1118888888888888888888888888888888888888888888888888888888811111111111111111111111111111111111111111111111111111111111111100000000000000001
1188888888888888888888888888888888888888888888888888888888811111111111100000000000000000000000001100000000000000000000111000000000000000001
1888888888888888888888888888888888888888888888888888888888811111111111100000000000000000000000001100000000000000000000000000000000000000001
1888858888888888888888888888888888888888888888888888888888811111111111100000000000000000000000001100000000000000000000000000000000000000001
1888888888888888888888888888888888888888888888888888888888811111111111100000000000000000000000001100000000000000000000000000000000000000001
1188888888888888888888888888888888888888888888888888888888811111111111100000000000000000000000001100000000000000000000111000000000000000001
1118888888888888888888888888888888888888888888888888888888811111111111111100000011111111111111111100000000000000000111111000000000000000001
1111111111111111100000000000000000000000000111111111111111111111111111111100000011111111111111111100000000000000000111111111111111111111111
1110222222222222000000000000000000000000000022222222222200000011111111111000000111111111111111111111111111100000111111111111111111111111111
1000000000000000000000000000000000000000000000000000000000000001111111111100000011111111111111111111111111110000011111111111111111111111111
0000000000000000000000000000000000000000000000000000000000000000000000000000000000000000000000000000000000000000000000001111111111111111111
0000000000000000000000000000000000000000000000000000000000000000000000000000000000000000000000000000000000000000000000001111111111111111111
0000000000000000000000000000000000000000000000000000000000000000000000000000000000000000000000000000000000000000000000001111111111111111111
1000000000000000000000000000000000000000000000000000000000000000000000000000000000000000000000000000000000000000000000001111111111111111111
0000000000000000000000000000000000000000000000000000000000000000000000777777777777777777777777777777777777700000000000000001111111111111111
0000000000000000000000000000000000000000000000000000000000000000000000111111666661111166666111116666611111100000000000000001111111111111111
0000000000000000000000000000000000000000000000000000000000000000000000111111666661111166666111116666611111100000000000000001111111116666611
1000000000000000000000000000000000000000000000000000000000000000000000111111666661111166666111116666611111100000000000000001111111116666611
1110000000000000000000000000000000000000000000000000000000000000000000000000000000000000000000000000000000000000000000000011111111116666611
1111111111111110000000011111111111111110000000000000000000000000000000000000000000000000000000000000000000000000000000000000000000000000011
1111111116666610000000016666611111111110000000000000000000000000000000111111111111111000000000111111111111111000000000000000000000000000011
1111111116666600000000006666611111111110044444444444444444444444444400118888888888880000000000088888888888811000000000000011111111111000011
1111111116666600000000006666611111111110044444444444444444444444444400118888888888880000000000088888888888811000000000000011111111111000011
1111111116666610000000016666611111111110044444444444444444444444444400118888888888881000000000188888888888811000000000000011100000000000011
1111111111111110000000011111111111111110044444444444444444444444444400118888888888881000000000188888888888811000000000000011100000000000011
1111111111111110000000011111111111111110044444444444444444444444444400111111111111111000000000111111111111111000000000000011111111111111111
1111111116666610000000016666611111111110044444444444444444444444444400118888888888880000000000088888888888811000000000000000000000000000001
1111111116666600000000006666611111111110044444444444444444444444444400118888888888880000000000088888888888811000000000000000000000000000001
1111111116666600000000006666611111111110044444444444444444444444444400118888888888881000000000188888888888811000000000000000000000000000001
1111111116666610000000016666611111111110044444444444444444444444444400118888888888881000000000188888888888811000000000000000000000000000001
1111111111111110000000011111111111111110044444444444444444444444444400111111111111111000000000111111111111111000000000000000000000000000001
1111111111111111000000111111111111111110044444444444444444444444444400111111111111111000000000111111111111111000000000000001111111111111111
1111188888888888888888888888888888111110044444444444444444444444444400111111111118888888888888888811111111111000000000000001111111111111111
1188888888888888888888888888888888888110044444444444444444444444444400111111188888888888888888888888881111111000000000000001111111111111111
1188888888888888888888888888888888888110044444444444444444444444444400111188888888888888888888888888888881111000000000000001111111111111111
1188888888888888888888888888888888888110044444444444444444444444444400111888888888888888888888888888888888111000000000000001111111111111111
1188888888888888888888888888888888888110044444444444444444444444444400111888888888888888888888888888888888111000000000000001111111111111111
1188888888888888888888888888888888888110044444444444444444444444444400111888888888888888888888888888888888111000000000000001111111111111111
1188888888888888888888888888888888888110044444444444444444444444444400111888888888888888888888888888888888111000000000000001111111111111111
1188888888888888888888888888888888888110044444444444444444444444444400111188888888888888888888888888888881111000000000000001111111111111111
1188888888888888888888888888888888888110044444444444444444444444444400111111188888888888888888888888881111111000000000000001111111111111111
1188888888888888888888888888888888888110044444444444444444444444444400111111118888888888888888888888811111111000000000000001111111111111111
1111188888888888888888888888888888111110044444444444444444444444444400111111111118888888888888888811111111111000000000000001111111111111111
1111111111111111888888111111111111111110044444444444444444444444444400111111111111111888888888111111111111111000000000000001111111111111111
1000000000000000000000000000000000000000000000000000000000000000000000000000000000000000000000000000000000000000000000000001111111111111111
1000000000000000000000000000000000000000000000000000000000000000000000000000000000000000000000000000000000000000000000000001111111111111111
1111111111111111111111111111111111111111111111111111111111111111111111111111111111111111111111111111111111111111111111111111111111111111111