1111111111111111111111111111111111111111111111111111111111111111111111111111111111111111111111111111111111111111111111111111111111111111111
1110000000000000000000000000000000000000000000000000000001111111111111111111111111111111111111111111111111111111111111111000000000000000001
1100000000000000000000000000000000000000000000000000000000111111111111100000000000000000000000001100000000000000000000111000000000000000001
1000000000000000000000000000000000000000000000000000000000011111111111100000000000000000000000001100000000000000000000000000000000000000001
1000000000000000000000000000000000000000000000000000000000011111111111100000000000000000000000001100000000000000000000000000000000000000001
1000000000000000000000000000000000000000000000000000000000011111111111100000000000000000000000001100000000000000000000000000000000000000001
1100000000000000000000000000000000000000000000000000000000111111111111100000000000000000000000001100000000000000000000111000000000000000001
1110000000000000000000000000000000000000000000000000000001111111111111111100000011111111111111111100000000000000000111111000000000000000001
1111111111111111100000000000000000000000000111111111111111111111111111111100000011111111111111111100000000000000000111111111111111111111111
1110000000000000000000000000000000000000000000000000000000000001111111111100000011111111111111111111111111110000011111111111111111111111111
1000000000000000000000000000000000000000000000000000000000000001111111111100000011111111111111111111111111110000011111111111111111111111111
0000000000000000000000000000000000000000000000000000000000000000000000000000000000000000000000000000000000000000000000001111111111111111111
0000000000000000000000000000000000000000000000000000000000000000000000000000000000000000000000000000000000000000000000001111111111111111111
0000000000000000000000000000000000000000000000000000000000000000000000000000000000000000000000000000000000000000000000001111111111111111111
1000000000000000000000000000000000000000000000000000000000000000000000000000000000000000000000000000000000000000000000001111111111111111111
0000000000000000000000000000000000000000000000000000000000000000000001111111111111111111111111111111111111000000000000000011111111111111111
0000000000000000000000000000000000000000000000000000000000000000000001111110000011111000001111100000111111000000000000000011111111111111111
0000000000000000000000000000000000000000000000000000000000000000000001111110000011111000001111100000111111000000000000000011111111111111111 
1000000000000000000000000000000000000000000000000000000000000000000001111110000011111000001111100000111111000000000000000011111111111111111
1110000000000000000000000000000000000000000000000000000000000000000000000000000000000000000000000000000000000000000000000011111111111111111
1111111111111110000000011111111111111110000000000000000000000000000000000000000000000000000000000000000000000000000000000000000000000000011
1111111110000010000000010000011111111110000000000000000000000000000000111111111111111000000000111111111111111000000000000000000000000000011
1111111110000000000000000000011111111110000000000000000000000000000000110000000000000000000000000000000000011000000000000011111111111000011
1111111110000000000000000000011111111110000000000000000000000000000000110000000000000000000000000000000000011000000000000011111111111000011
1111111110000010000000010000011111111110000000000000000000000000000000110000000000001000000000100000000000011000000000000011100000000000011
1111111111111110000000011111111111111110000000000000000000000000000000110000000000001000000000100000000000011000000000000011100000000000011
1111111111111110000000011111111111111110000000000000000000000000000000111111111111111000000000111111111111111000000000000011111111111111111
1111111110000010000000010000011111111110000000000000000000000000000000110000000000000000000000000000000000011000000000000000000000000000001
1111111110000000000000000000011111111110000000000000000000000000000000110000000000000000000000000000000000011000000000000000000000000000001
1111111110000000000000000000011111111110000000000000000000000000000000110000000000001000000000100000000000011000000000000000000000000000001
1111111110000010000000010000011111111110000000000000000000000000000000110000000000001000000000100000000000011000000000000000000000000000001
1111111111111110000000011111111111111110000000000000000000000000000000111111111111111000000000111111111111111000000000000000000000000000001
1111111111111111000000111111111111111110000000000000000000000000000000111111111111111000000000111111111111111000000000000001111111111111111
1111100000000000000000000000000000111110000000000000000000000000000000111111111110000000000000000011111111111000000000000001111111111111111
1100000000000000000000000000000000000110000000000000000000000000000000111111110000000000000000000000011111111000000000000001111111111111111
1110000000000000000000000000000000001110000000000000000000000000000000111110000000000000000000000000000011111000000000000001111111111111111
1100000000000000000000000000000000000110000000000000000000000000000000111110000000000000000000000000000011111000000000000001111111111111111
1100000000000000000000000000000000000110000000000000000000000000000000111000000000000000000000000000000000111000000000000001111111111111111
1100000000000000000000000000000000000110000000000000000000000000000000111000000000000000000000000000000000111000000000000001111111111111111
1100000000000000000000000000000000000110000000000000000000000000000000111000000000000000000000000000000000111000000000000001111111111111111
1100000000000000000000000000000000000110000000000000000000000000000000111110000000000000000000000000000011111000000000000001111111111111111
1100000000000000000000000000000000000110000000000000000000000000000000111110000000000000000000000000000011111000000000000001111111111111111
1100000000000000000000000000000000000110000000000000000000000000000000111111110000000000000000000000011111111000000000000001111111111111111
1111100000000000000000000000000000111110000000000000000000000000000000111111111110000000000000000011111111111000000000000001111111111111111
1111111111111111000000111111111111111110000000000000000000000000000000111111111111111000000000111111111111111000000000000001111111111111111
1000000000000000000000000000000000000000000000000000000000000000000000000000000000000000000000000000000000000000000000000001111111111111111
1000000000000000000000000000000000000000000000000000000000000000000000000000000000000000000000000000000000000000000000000001111111111111111
1111111111111111111111111111111111111111111111111111111111111111111111111111111111111111111111111111111111111111111111111111111111111111111